----> 3 класс

Этап 1
this = этот (эта, это)
that = тот (та, то)
these = эти
those = те
my = мой
your = твой
his = его
her = её
have = иметь

Этап 2
king = король
ring = кольцо
wing = крыло
stocking = чулок
kangaroo = кенгуру
english = английский
pink = розовый
bank = банк

Этап 3
ping-pong = пинг-понг
skating rink = ледовый каток
song = песня
morning = утро
evening = вечер
thank = благодарить

Этап 4
flower = цветок
tower = башня
shower = душ
chair = стул
bear = медведь
teddy bear = плюшевый мишка
parents = родители
grandparents = бабушка с дедушкой
mother = мать
father = отец

Этап 5
my = мой
your = твой
his = его
her = её
our = наш
their = их

Этап 6
eat = есть (пищу)
read = читать
speak = говорить
teach = учить
very = очень
well = хорошо

Этап 7
sparrow = воробей
yellow = желтый
window = окно
rainbow = радуга
low = низкий
slow = медленный
narrow = узкий

Этап 8
black = черный
red = красный
yellow = желтый
brown = коричневый
green = зеленый
pink = розовый
blue = синий
purple = фиолетовый

Этап 9
grey = серый
white = белый
dark blue = темно-синий
dark green = темно-зеленый
dark brown = темно-коричневый
dark grey = темно-серый
light = светлый
bright = яркий

Этап 10
can't = не может
weak = слабый
old = старый
fat = толстый (жирный)
thick = толстый (предмет)
young = молодой
thin = тонкий, худой
strong = сильный
new = новый

Этап 11
ball = мяч
wall = стена
hall = прихожая
small = маленький
tall = высокий

Этап 12
long = длинный
short = короткий
clean = чистый
dirty = грязный

Этап 13
thirteen = тринадцать
fourteen = четырнадцать
fifteen = пятнадцать
sixteen = шестнадцать
seventeen = семнадцать
eighteen = восемнадцать
nineteen = девятнадцать
twenty = двадцать

Этап 14
drive = водить машину
write = писать
skate = кататься на коньках
ski = кататься на лыжах
count = считать
dance = танцевать

Этап 15
snail = улитка
tail = хвост
train = поезд
coins = монеты
pointer = указка
toys = игрушки

Этап 16
family = семья
candle = свеча
table = стол
present = подарок
wife = жена
husband = муж
friend = друг

Этап 17
sunday = воскресенье
monday = понедельник
tuesday = вторник
wednesday = среда
thursday = четверг
friday = пятница
saturday = суббота

Этап 18
fire = огонь
diary = дневник
giant = гигант
tired = уставший
hungry = голодный
thirsty = жаждущий
sick = больной

Этап 19
gym = стортзал
cage = клетка
stage = сцена
page = страница
general = генерал
sledge = сани

Этап 20
mice = мыши
ice cream = мороженое
cinema = кинотеатр
ice = лед
pencil = карандаш
go = идти (ехать)

Этап 21
giraffe = жираф
crocodile = крокодил
elephant = слон
tiger = тигр
lion = лев
hare = заяц
animals = животные

Этап 22
live = жить
love = любить
hate = ненавидеть
like = нравится

Этап 23
year = год
near = рядом
clear = ясный (чистый)
here = здесь
spring = весна
summer = лето
autumn = осень
winter = зима

Этап 24
month = месяц
january = январь
february = февраль
march = март
april = апрель
may = май
june = июнь
july = июль
august = август
september = сентябрь
october = октябрь
november = ноябрь
december = декабрь

Этап 25
season = время года
week = неделя
late = поздний
early = ранний
beautiful = красивый
pleasant = приятный

Этап 26
canada = канада
spain = испания
india = индия
britain = англия
russia = россия
italy = италия
france = франция
the usa = США

